0 0 2 0 2 0
0 5 0 0 7 0
1 5 0 3 7 0
0 3 0 2 7 0
0 3 0 0 0 0
0 8 8 8 8 0